%BASISPACKAGEPREFIX%WITHOUTDOTPRODUCTVERSION-%LANGUAGESTRING	Language module for LibreOffice %PRODUCTVERSION, language %LANGUAGESTRING
%BASISPACKAGEPREFIX%WITHOUTDOTPRODUCTVERSION-%LANGUAGESTRING-base	Base language module for LibreOffice %PRODUCTVERSION, language %LANGUAGESTRING
%BASISPACKAGEPREFIX%WITHOUTDOTPRODUCTVERSION-%LANGUAGESTRING-calc	Calc language module for LibreOffice %PRODUCTVERSION, language %LANGUAGESTRING
%BASISPACKAGEPREFIX%WITHOUTDOTPRODUCTVERSION-%LANGUAGESTRING-draw	Draw language module for LibreOffice %PRODUCTVERSION, language %LANGUAGESTRING
%BASISPACKAGEPREFIX%WITHOUTDOTPRODUCTVERSION-%LANGUAGESTRING-fonts	Language fonts module for LibreOffice %PRODUCTVERSION, language %LANGUAGESTRING
%BASISPACKAGEPREFIX%WITHOUTDOTPRODUCTVERSION-%LANGUAGESTRING-help	Language help module for LibreOffice %PRODUCTVERSION, language %LANGUAGESTRING
%BASISPACKAGEPREFIX%WITHOUTDOTPRODUCTVERSION-%LANGUAGESTRING-impress	Impress language module for LibreOffice %PRODUCTVERSION, language %LANGUAGESTRING
%BASISPACKAGEPREFIX%WITHOUTDOTPRODUCTVERSION-%LANGUAGESTRING-math	Math language module for LibreOffice %PRODUCTVERSION, language %LANGUAGESTRING
%BASISPACKAGEPREFIX%WITHOUTDOTPRODUCTVERSION-%LANGUAGESTRING-onlineupd	Online update language module for LibreOffice %PRODUCTVERSION, language %LANGUAGESTRING
%BASISPACKAGEPREFIX%WITHOUTDOTPRODUCTVERSION-%LANGUAGESTRING-res	Language resource module for LibreOffice %PRODUCTVERSION, language %LANGUAGESTRING
%BASISPACKAGEPREFIX%WITHOUTDOTPRODUCTVERSION-%LANGUAGESTRING-writer	Writer language module for LibreOffice %PRODUCTVERSION, language %LANGUAGESTRING
%BASISPACKAGEPREFIX%WITHOUTDOTPRODUCTVERSION-activex	ActiveX control for LibreOffice %PRODUCTVERSION
%BASISPACKAGEPREFIX%WITHOUTDOTPRODUCTVERSION-base	Base module for LibreOffice %PRODUCTVERSION
%BASISPACKAGEPREFIX%WITHOUTDOTPRODUCTVERSION-calc	Calc module for LibreOffice %PRODUCTVERSION
%BASISPACKAGEPREFIX%WITHOUTDOTPRODUCTVERSION-core01	Core module for LibreOffice %PRODUCTVERSION
%BASISPACKAGEPREFIX%WITHOUTDOTPRODUCTVERSION-core02	Office core module for LibreOffice %PRODUCTVERSION
%BASISPACKAGEPREFIX%WITHOUTDOTPRODUCTVERSION-core03	Office core module for LibreOffice %PRODUCTVERSION
%BASISPACKAGEPREFIX%WITHOUTDOTPRODUCTVERSION-core04	Office core module for LibreOffice %PRODUCTVERSION
%BASISPACKAGEPREFIX%WITHOUTDOTPRODUCTVERSION-core05	Office core module for LibreOffice %PRODUCTVERSION
%BASISPACKAGEPREFIX%WITHOUTDOTPRODUCTVERSION-core06	Office core module for LibreOffice %PRODUCTVERSION
%BASISPACKAGEPREFIX%WITHOUTDOTPRODUCTVERSION-core07	Office core module for LibreOffice %PRODUCTVERSION
%BASISPACKAGEPREFIX%WITHOUTDOTPRODUCTVERSION-dict-gl	Gl dictionary for %PRODUCTNAME %PRODUCTVERSION
%BASISPACKAGEPREFIX%WITHOUTDOTPRODUCTVERSION-dict-vi	Vietnamese dictionary for %PRODUCTNAME %PRODUCTVERSION
%BASISPACKAGEPREFIX%WITHOUTDOTPRODUCTVERSION-draw	Draw module for LibreOffice %PRODUCTVERSION
%BASISPACKAGEPREFIX%WITHOUTDOTPRODUCTVERSION-emailmerge	Email mailmerge module for LibreOffice %PRODUCTVERSION
%BASISPACKAGEPREFIX%WITHOUTDOTPRODUCTVERSION-gnome-integratn	Gnome integration module for LibreOffice %PRODUCTVERSION
%BASISPACKAGEPREFIX%WITHOUTDOTPRODUCTVERSION-graphicfilter	Graphic filter module for LibreOffice %PRODUCTVERSION
%BASISPACKAGEPREFIX%WITHOUTDOTPRODUCTVERSION-headless	Headless display module for LibreOffice %PRODUCTVERSION
%BASISPACKAGEPREFIX%WITHOUTDOTPRODUCTVERSION-images	Images module for LibreOffice %PRODUCTVERSION
%BASISPACKAGEPREFIX%WITHOUTDOTPRODUCTVERSION-impress	Impress module for LibreOffice %PRODUCTVERSION
%BASISPACKAGEPREFIX%WITHOUTDOTPRODUCTVERSION-kde-integration	KDE integration module for LibreOffice %PRODUCTVERSION
%BASISPACKAGEPREFIX%WITHOUTDOTPRODUCTVERSION-math	Math module for LibreOffice %PRODUCTVERSION
%BASISPACKAGEPREFIX%WITHOUTDOTPRODUCTVERSION-onlineupdate	Online update modul for LibreOffice %PRODUCTVERSION
%BASISPACKAGEPREFIX%WITHOUTDOTPRODUCTVERSION-ooofonts	Mailcap module for LibreOffice %PRODUCTVERSION
%BASISPACKAGEPREFIX%WITHOUTDOTPRODUCTVERSION-ooolinguistic	Linguistic module for LibreOffice %PRODUCTVERSION
%BASISPACKAGEPREFIX%WITHOUTDOTPRODUCTVERSION-pyuno	Pyuno module for LibreOffice %PRODUCTVERSION
%BASISPACKAGEPREFIX%WITHOUTDOTPRODUCTVERSION-spellcheck	English spellchecker module for LibreOffice %PRODUCTVERSION
%BASISPACKAGEPREFIX%WITHOUTDOTPRODUCTVERSION-testtool	Testtool module for LibreOffice %PRODUCTVERSION
%BASISPACKAGEPREFIX%WITHOUTDOTPRODUCTVERSION-writer	Writer module for LibreOffice %PRODUCTVERSION
%BASISPACKAGEPREFIX%WITHOUTDOTPRODUCTVERSION-xsltfilter	XSLT filter samples module for LibreOffice %PRODUCTVERSION
%PACKAGEPREFIX%SOLARISBRANDPACKAGENAME%BRANDPACKAGEVERSION-dict-af	Af dictionary for %PRODUCTNAME %PRODUCTVERSION
%PACKAGEPREFIX%SOLARISBRANDPACKAGENAME%BRANDPACKAGEVERSION-dict-cs	Cs dictionary for %PRODUCTNAME %PRODUCTVERSION
%PACKAGEPREFIX%SOLARISBRANDPACKAGENAME%BRANDPACKAGEVERSION-dict-da	Da dictionary for %PRODUCTNAME %PRODUCTVERSION
%PACKAGEPREFIX%SOLARISBRANDPACKAGENAME%BRANDPACKAGEVERSION-dict-de	De dictionary for %PRODUCTNAME %PRODUCTVERSION
%PACKAGEPREFIX%SOLARISBRANDPACKAGENAME%BRANDPACKAGEVERSION-dict-en	En dictionary for %PRODUCTNAME %PRODUCTVERSION
%PACKAGEPREFIX%SOLARISBRANDPACKAGENAME%BRANDPACKAGEVERSION-dict-es	Es dictionary for %PRODUCTNAME %PRODUCTVERSION
%PACKAGEPREFIX%SOLARISBRANDPACKAGENAME%BRANDPACKAGEVERSION-dict-et	Et dictionary for %PRODUCTNAME %PRODUCTVERSION
%PACKAGEPREFIX%SOLARISBRANDPACKAGENAME%BRANDPACKAGEVERSION-dict-fr	Fr dictionary for %PRODUCTNAME %PRODUCTVERSION
%PACKAGEPREFIX%SOLARISBRANDPACKAGENAME%BRANDPACKAGEVERSION-dict-hu	Hu dictionary for %PRODUCTNAME %PRODUCTVERSION
%PACKAGEPREFIX%SOLARISBRANDPACKAGENAME%BRANDPACKAGEVERSION-dict-hr	Hr dictionary for %PRODUCTNAME %PRODUCTVERSION
%PACKAGEPREFIX%SOLARISBRANDPACKAGENAME%BRANDPACKAGEVERSION-dict-it	It dictionary for %PRODUCTNAME %PRODUCTVERSION
%PACKAGEPREFIX%SOLARISBRANDPACKAGENAME%BRANDPACKAGEVERSION-dict-lt	Lt dictionary for %PRODUCTNAME %PRODUCTVERSION
%PACKAGEPREFIX%SOLARISBRANDPACKAGENAME%BRANDPACKAGEVERSION-dict-ne	Ne dictionary for %PRODUCTNAME %PRODUCTVERSION
%PACKAGEPREFIX%SOLARISBRANDPACKAGENAME%BRANDPACKAGEVERSION-dict-nl	Nl dictionary for %PRODUCTNAME %PRODUCTVERSION
%PACKAGEPREFIX%SOLARISBRANDPACKAGENAME%BRANDPACKAGEVERSION-dict-pl	Pl dictionary for %PRODUCTNAME %PRODUCTVERSION
%PACKAGEPREFIX%SOLARISBRANDPACKAGENAME%BRANDPACKAGEVERSION-dict-pt	Pt dictionary for %PRODUCTNAME %PRODUCTVERSION
%PACKAGEPREFIX%SOLARISBRANDPACKAGENAME%BRANDPACKAGEVERSION-dict-ru	Ru dictionary for %PRODUCTNAME %PRODUCTVERSION
%PACKAGEPREFIX%SOLARISBRANDPACKAGENAME%BRANDPACKAGEVERSION-dict-sk	Sk dictionary for %PRODUCTNAME %PRODUCTVERSION
%PACKAGEPREFIX%SOLARISBRANDPACKAGENAME%BRANDPACKAGEVERSION-dict-sl	Sl dictionary for %PRODUCTNAME %PRODUCTVERSION
%PACKAGEPREFIX%SOLARISBRANDPACKAGENAME%BRANDPACKAGEVERSION-dict-sv	Sv dictionary for %PRODUCTNAME %PRODUCTVERSION
%PACKAGEPREFIX%SOLARISBRANDPACKAGENAME%BRANDPACKAGEVERSION-dict-sw	Sw dictionary for %PRODUCTNAME %PRODUCTVERSION
%PACKAGEPREFIX%SOLARISBRANDPACKAGENAME%BRANDPACKAGEVERSION-dict-th	Th dictionary for %PRODUCTNAME %PRODUCTVERSION
%PACKAGEPREFIX%SOLARISBRANDPACKAGENAME%BRANDPACKAGEVERSION-dict-zu	Zu dictionary for %PRODUCTNAME %PRODUCTVERSION
%WITHOUTDOTUNIXPACKAGENAME%BRANDPACKAGEVERSION	Brand module for %PRODUCTNAME %PRODUCTVERSION
%WITHOUTDOTUNIXPACKAGENAME%BRANDPACKAGEVERSION-%LANGUAGESTRING	Brand language module for %PRODUCTNAME %PRODUCTVERSION
%WITHOUTDOTUNIXPACKAGENAME%BRANDPACKAGEVERSION-base	Base brand module for %PRODUCTNAME %PRODUCTVERSION
%WITHOUTDOTUNIXPACKAGENAME%BRANDPACKAGEVERSION-calc	Calc brand module for %PRODUCTNAME %PRODUCTVERSION
%WITHOUTDOTUNIXPACKAGENAME%BRANDPACKAGEVERSION-draw	Draw brand module for %PRODUCTNAME %PRODUCTVERSION
%WITHOUTDOTUNIXPACKAGENAME%BRANDPACKAGEVERSION-impress	Impress brand module for %PRODUCTNAME %PRODUCTVERSION
%WITHOUTDOTUNIXPACKAGENAME%BRANDPACKAGEVERSION-math	Math brand module for %PRODUCTNAME %PRODUCTVERSION
%WITHOUTDOTUNIXPACKAGENAME%BRANDPACKAGEVERSION-writer	Writer brand module for %PRODUCTNAME %PRODUCTVERSION
